110000000000011
100000000000001
001003333300100
001000030000100
001003333300100
001000000000100
001000070000100
001000070000100
001110070011100
000000070000000
007700000007700
107700111007701
110000111000011
