000000000000000
000000000000000
001003333300100
001003333300100
001000000000100
001000000000100
001000070000100
001000070000100
001110070011100
000000070000000
007700000007700
007700111007700
000000111000000
