0000000000000
0000000000000
0003330003330
0000000000000
0000100010000
0000100010000
0000100010000
0000111110000
0000100010000
0000100010000
0000000000000
0001110000000
0000000111100
0000000000000
0000000000000



