110000000000011
100000000000001
100333000333000
000000000000000
000010001000000
000010001000000
000010001000000
000011111000000
000010001000000
000010001000000
000000000000000
100111000000001
110000011110011



